##########
#      o #
#        #
#   &*   #
#-     s #  
##########