              ############
              #   *  *  *#
              #          #
##########    #          #
#r  +  o*#    #   *  &  *#
#        ######          #
#  ¥                     #
#-     s ######   *  *  *#
##########    ############