##########
#r  +  o*#
#        #
#  ¥&    #
#-     s #  
##########