##########    #########
#r  +  o*#    #   *  &#
#        ######       #
#  ¥                  #
#-     s ######   *  *#
##########    #########